

NO Tools/textures_2/Miscellaneous_Walls.png
EA Tools/textures_2/Miscellaneous_Walls.png
SO Tools/textures_2/Miscellaneous_Walls.png
WE Tools/textures_2/Miscellaneous_Walls.png
DR Tools/textures_2/door.png
PR Tools/textures_2/1337.png


C 0, 0, 0
F 10, 20, 30






1111111111111111111111111
1000000000000000000200001
100000000N000000000000001
1000000000000000000000001
1000000100000000001000001
1000000200000000001111121
1000000100000040001000001
1000000100000000000000001
1000000100000000010000001
1111111111111111111111111