

NO Tools/textures/simonkraft/respawn_anchor_side0.xpm
EA Tools/textures/simonkraft/respawn_anchor_side2.xpm
SO Tools/textures/simonkraft/respawn_anchor_side4.xpm
WE Tools/textures/simonkraft/respawn_anchor_side3.xpm




F 52,254,0000000
C 35,19,73






1111111111111111111111111
1000000000000000000000001
1000000000000000000011111
1000000000010010000000001
1001010000110011000101001
1000100000000000000010001
1001010000110011000101001
1000000000010010000000001
1111100000000000000000001
10E0000000000000000000001
1111111111111111111111111
