
NO Tools/textures_2/M_W.png
EA Tools/textures_2/M_W.png
SO Tools/textures_2/M_W.png
WE Tools/textures_2/M_W.png

DR Tools/textures_2/door.png
PR Tools/textures_2/1337.png


LV map2.cub



C 20, 90, 255
F 10, 20, 40 



1111111111111111111111111
1000000000000000000000001
1000000000000000000000001
1000000000000000000011111
1000000000010010000000001
1001010000110011000101001
1000100000200002000010001
1001010000110011000101001
1000000000010010000000001
1111100020400000000000001
10S0000000000000000000001
1111111111111111111111111