

NO Tools/textures_2/Miscellaneous_Walls.png
EA Tools/textures_2/Miscellaneous_Walls.png
SO Tools/textures_2/Miscellaneous_Walls.png
WE Tools/textures_2/Miscellaneous_Walls.png





C 20, 90, 255
F 10, 20, 40






1111111111111111111111111
1000000000000000000000001
1000000000000000000000001
100000000S000000000000001
1000000100000000001000001
1000000100000000001000001   11111111
1000000100000000001000001    10000001
100000010000000000100000111   1100000111
100000010000000000100000001     110000001
10000001000000000010000011111   10000001
10000001000000000010000000001  11111111
10000001000000000010000011111
1000000100000000001000001
1000000100000000001000001
1000000100000000001000001
1000000100000000001000001
1000000100000000001000001
1000000100000000001000001
1000000100000000001110111
1000000100000000001 101
1000000100000000001110111
1000000100000000001000001
1000000100000000001000001
1000000100000000001000001
1000000100000000001000001
1000000100000000001000001
1000000100000000001000001
1000000100000000001000001
1000000100000000001000001
1000000100000000001000001
1000000000000000000000001
1000000000000000000000001
1111111111111111111111111