
NO Tools/textures_2/M_W.png
EA Tools/textures_2/M_W.png
SO Tools/textures_2/M_W.png
WE Tools/textures_2/M_W.png

DR Tools/textures_2/door.png
PR Tools/textures_2/1337.png

LV map3.cub


C 20, 90, 255
F 10, 20, 10





1111111111111111111111111
10S0002000000040000000001
1000002000000000000000001
1111111111111111111111111
