
NO Tools/textures_2/M_W.png
EA Tools/textures_2/M_W.png
SO Tools/textures_2/M_W.png
WE Tools/textures_2/M_W.png

DR Tools/textures_2/door.png
PR Tools/textures_2/1337.png



C 20, 90, 255
F 10, 20, 10




1111111111111111111111111
1000000000000000000000001
1000222222400000000000001          11111111
100000000N0000000000000011111111111100000001
1000000100000000001000000000000000000000001
10000002000000000010000011111111111100004001
1000000100000000001000001           1111111
1000000100000000001000001
1000000100000000001000001
1111111111111111111111111